101
111
1111111111111111111111111111111111111111111111111111111111111111111111111111111111111111111111111111
1111111111111111111111111111111111111111111111111111111111111111111111111111111111111111111111111111
1111111111111111111111111111111111111111111111111111111111111111111111111111111111111111111111111111
1111111111111111111111111111111111111111111111111111111111111111111111111111111111111111111111111111
1111111111111111111111111111111111111111111111111111111111111111111111111111111111111111111111111111
1111111111111111111111111111111111111111111111111111111111111111111111111111111111111111111111111111
1111111111111111111111111111111111111111111111111111111111111111111111111111111111111111111111111111
1111111111111111111111111111111111111111111111111111111111111111111111111111111111111111111111111111
1111111111111111111111111111111111111111111111111111111111111111111111111111111111111111111111111111
1111111111111111111111111111111111111111111111111111111111111111111111111111111111111111111111111111
1111111111111111111111111111111111111111111111111111111111111111111111111111111111111111111111111111
1111111111111111111110000000000000000000000000000000000000000000000000000000000011111111111111111111
1111111111111111111110000000000000000000000000000000000000000000000000000000000011111111111111111111
1111111111111111111110000000000000000000000000000000000000000000000000000000000011111111111111111111
1111111111111111111110000000000000000000000000000000000000000000000000000000000011111111111111111111
1111111111111111111110000000000000000000000000000000000000000000000000000000000011111111111111111111
1111111111111111111110300000000000000000000000000000000000000000000000000000000011111111111111111111
1111111111111111111110000000000000000000000000000000000000000000000000000000000011111111111111111111
1111111111111111111110000000000000000000000000000000000000000000000000000000000011111111111111111111
1111111111111111111110000000000000000000000000000000000000000000000000000000000011111111111111111111
1111111111111111111110000000001111111111111111111111111111111111111111100000000011111111111111111111
1111111111111111111110000000001111111111111111111111111111111111111111100000000011111111111111111111
1111111111111111111110000000001111111111111111111111111111111111111111100000000011111111111111111111
1111111111111111111110000000001111111111111111111111111111111111111111100000000011111111111111111111
1111111111111111111110000000001111111111111111111111111111111111111111100000000011111111111111111111
1111111111111111111110000000001111111111111111111111111111111111111111100000000011111111111111111111
1111111111111111111110000000001111111111111111111111111111111111111111100000000011111111111111111111
1111111111111111111110000000001111111111111111111111111111111111111111100000000011111111111111111111
1111111111111111111110000000001111111111111111111111111111111111111111100000000011111111111111111111
1111111111111111111110000000001111111111111111111111111111111111111111100000000011111111111111111111
1111111111111111111110000000001111111111111111111111111111111111111111100000000011111111111111111111
1111111111111111111110000000001111111111111111111111111111111111111111100000000011111111111111111111
1111111111111111111110000000001111111111111111111111111111111111111111100000000011111111111111111111
1111111111111111111110000000001111111111111111111111111111111111111111100000000011111111111111111111
1111111111111111111110000000001111111111111111111111111111111111111111100000000011111111111111111111
1111111111111111111110000000001111111111111111111111111111111111111111100000000011111111111111111111
1111111111111111111110000000001111111111111111111111111111111111111111100000000011111111111111111111
1111111111111111111110000000001111111111111111111111111111111111111111100000000011111111111111111111
1111111111111111111110000000001111111111111111111111111111111111111111100000000011111111111111111111
1111111111111111111110000000001111111111111111111111111111111111111111100000000011111111111111111111
1111111111111111111110000000001111111111111111111111111111111111111111100000000011111111111111111111
1111111111111111111110000000001111111111111111111111111111111111111111100000000011111111111111111111
1111111111111111111110000000001111111111111111111111111111111111111111100000000011111111111111111111
1111111111111111111110000000001111111111111111111111111111111111111111100000000011111111111111111111
1111111111111111111110000000001111111111111111111111111111111111111111100000000011111111111111111111
1111111111111111111110000000001111111111111111111111111111111111111111100000000011111111111111111111
1111111111111111111110000000001111111111111111111111111111111111111111100000000011111111111111111111
1111111111111111111110000000001111111111111111111111111111111111111111100000000011111111111111111111
1111111111111111111110000000001111111111111111111111111111111111111111100000000011111111111111111111
1111111111111111111110000000001111111111111111111111111111111111111111100000000011111111111111111111
1111111111111111111110000000001111111111111111111111111111111111111111100000000011111111111111111111
1111111111111111111110000000001111111111111111111111111111111111111111100000000011111111111111111111
1111111111111111111110000000001111111111111111111111111111111111111111100000000011111111111111111111
1111111111111111111110000000001111111111111111111111111111111111111111100000000011111111111111111111
1111111111111111111110000000001111111111111111111111111111111111111111100000000011111111111111111111
1111111111111111111110000000001111111111111111111111111111111111111111100000000011111111111111111111
1111111111111111111110000000001111111111111111111111111111111111111111100000000011111111111111111111
1111111111111111111110000000001111111111111111111111111111111111111111100000000011111111111111111111
1111111111111111111110000000001111111111111111111111111111111111111111100000000011111111111111111111
1111111111111111111110000000001111111111111111111111111111111111111111100000000011111111111111111111
1111111111111111111110000000001111111111111111111111111111111111111111100000000011111111111111111111
1111111111111111111110000000001111111111111111111111111111111111111111100000000011111111111111111111
1111111111111111111110000000001111111111111111111111111111111111111111100000000011111111111111111111
1111111111111111111110000000001111111111111111111111111111111111111111100000000011111111111111111111
1111111111111111111110000000001111111111111111111111111111111111111111100000000011111111111111111111
1111111111111111111110000000001111111111111111111111111111111111111111100000000011111111111111111111
1111111111111111111110000000001111111111111111111111111111111111111111100000000011111111111111111111
1111111111111111111110000000001111111111111111111111111111111111111111100000000011111111111111111111
1111111111111111111110000000001111111111111111111111111111111111111111100000000011111111111111111111
1111111111111111111110000000001111111111111111111111111111111111111111100000000011111111111111111111
1111111111111111111110000000001111111111111111111111111111111111111111100000000011111111111111111111
1111111111111111111110000000001111111111111111111111111111111111111111100000000011111111111111111111
1111111111111111111110000000001111111111111111111111111111111111111111100000000011111111111111111111
1111111111111111111110000000001111111111111111111111111111111111111111100000000011111111111111111111
1111111111111111111110000000001111111111111111111111111111111111111111100000000011111111111111111111
1111111111111111111110000000001111111111111111111111111111111111111111100000000011111111111111111111
1111111111111111111110000000001111111111111111111111111111111111111111100000000011111111111111111111
1111111111111111111110000000001111111111111111111111111111111111111111100000000011111111111111111111
1111111111111111111110000000001111111111111111111111111111111111111111100000000011111111111111111111
1111111111111111111110000000001111111111111111111111111111111111111111100000000011111111111111111111
1111111111111111111110000000001111111111111111111111111111111111111111100000000011111111111111111111
1111111111111111111110000000000000000000000000000000000000000000000000000000000011111111111111111111
1111111111111111111110000000000000000000000000000000000000000000000000000000000011111111111111111111
1111111111111111111110000000000000000000000000000000000000000000000000000000000011111111111111111111
1111111111111111111110000000000000000000000000000000000000000000000000000000000011111111111111111111
1111111111111111111110000000000000000000000000000000000000000000000000000000000011111111111111111111
1111111111111111111110000000000000000000000000000000000000000000000000000000000011111111111111111111
1111111111111111111110000000000000000000000000000000000000000000000000000000000011111111111111111111
1111111111111111111110000000000000000000000000000000000000000000000000000000000011111111111111111111
1111111111111111111110000000000000000000000000000000000000000000000000000000000011111111111111111111
1111111111111111111111111111111111111111111111111111111111111111111111111111111111111111111111111111
1111111111111111111111111111111111111111111111111111111111111111111111111111111111111111111111111111
1111111111111111111111111111111111111111111111111111111111111111111111111111111111111111111111111111
1111111111111111111111111111111111111111111111111111111111111111111111111111111111111111111111111111
1111111111111111111111111111111111111111111111111111111111111111111111111111111111111111111111111111
1111111111111111111111111111111111111111111111111111111111111111111111111111111111111111111111111111
1111111111111111111111111111111111111111111111111111111111111111111111111111111111111111111111111111
1111111111111111111111111111111111111111111111111111111111111111111111111111111111111111111111111111
1111111111111111111111111111111111111111111111111111111111111111111111111111111111111111111111111111
1111111111111111111111111111111111111111111111111111111111111111111111111111111111111111111111111111
1111111111111111111111111111111111111111111111111111111111111111111111111111111111111111111111111111
1111111111111111111111111111111111111111111111111111111111111111111111111111111111111111111111111111
1111111111111111111111111111111111111111111111111111111111111111111111111111111111111111111111111111
1111111111111111111111111111111111111111111111111111111111111111111111111111111111111111111111111111
1111111111111111111111111111111111111111111111111111111111111111111111111111111111111111111111111111
1111111111111111111111111111111111111111111111111111111111111111111111111111111111111111111111111111
1111111111111111111111111111111111111111111111111111111111111111111111111111111111111111111111111111
1111111111111111111111111111111111111111111111111111111111111111111111111111111111111111111111111111
1111111111111111111111111111111111111111111111111111111111111111111111111111111111111111111111111111
1111111111111111111111111111111111111111111111111111111111111111111111111111111111111111111111111111
